NO assets/textures/wall_n.xpm
SO assets/textures/wall_s.xpm
WE assets/textures/wall_w.xpm
EA assets/textures/wall_e.xpm
F 59,59,59
C 135,206,235
1111111111111111111111111
1                       1
1 110000011100000000000 1
1 010000000000000000000 1
1 111111101100000111000 111111111
1 000000001100000111011    111111
1 1101111111110111000000000 1
1 1101111111110111010100000 1
1 0000001111111111111110000 11111111
1 00000000       W111110000        1
1 00000            11110000 1111111
1 0000 1110101 111 10111100 111
1      1 11101 1 1          1
11111111 1111111 111111111111
