NO assets/textures/wall_n.xpm
SO assets/textures/wall_s.xpm
WE assets/textures/wall_w.xpm
EA assets/textures/wall_e.xpm
F 59,59,59
C 135,206,235
1111111111111111111111111
10000000001100000S0000001
10110000011100000 0000001
10010000000000000 0000001
11111111101100000 110000111111111
10000000001100000 110111111111111
11110111111111011 00000010001
11110111111111011 01010010001
11000000111111111 111111111111111111
10000000001111111 111111111111111111
10000000001111111 11111111111111111
1100000111010101111101111000111
11110111 1110101 101111010001
11111111 1111111 111111111111
