NO assets/textures/wall_n.xpm
SO assets/textures/wall_s.xpm
WE assets/textures/wall_w.xpm
EA assets/textures/wall_e.xpm
F 59,59,59
C 135,206,235
         111111111  111111111111111111
         100000001  100000000000000001
         10110000111100000001111111111
11111111110000000000000000011111
1000000         01111000100N1111111111
100000001  100110101010000001
10000000111110000001010100001
11111111111111111111011111111
1111 111111111111110011111111
1111 100000000000000000000001
1111 111111111111111111111111
