NO assets/textures/wall_n.xpm
SO assets/textures/wall_s.xpm
WE assets/textures/wall_w.xpm
EA assets/textures/wall_e.xpm
F 59,59,59
C 135,206,235
     11111  
    100S001
     10001
      101
       1
