NO assets/textures/wall_n.xpm
SO assets/textures/wall_s.xpm
WE assets/textures/wall_w.xpm
EA assets/textures/wall_e.xpm
F 59,59,59
C 135,206,235
1111111111111111111111111
1111111111111111111111111
1111111111111111111111111
1111111111111111111111111
111111111111111111111111111111111
111111111111111111111111111111111
11111111111111111111111111111
11111111111111111111111111111
11111111111111111111111111111
11111111111111111111111111111
11111111111111111111111111111
11111111111111111111111111N1111
111111111111111111111111111
111111111111111111111111111
