NO assets/textures/wall_n.xpm
SO assets/textures/wall_s.xpm
WE assets/textures/wall_w.xpm
EA assets/textures/wall_e.xpm
F 59,59,59
C 135,206,235
        1111111111111111111111111
        1000000000110000000000001        00000
        1011000001110000000000001        00000
        10W1000000000000000000001        00000
111111111011000001110000000000001        00000
100000000011000001110111111111111        00000
11110111111111011100000010001
11110111111111011101010010001
11000000110101011100000010001
10000000000000001100000010001
10000000000000001101010010001
1100000111010101111101111000111
11110111 1110101 101111010001
11111111 1111111 111111111111
