NO assets/textures/wall_n.xpm
SO assets/textures/wall_s.xpm
WE assets/textures/wall_w.xpm
EA assets/textures/wall_e.xpm
F 220,100,0
C 225,30,0
1111111111111111111111111
1020000090110000050002001
1011000001110000000000001
1001000000000000000000001
111111111011000001110000000000001
100000000011000001110111111111111
11110111113111011100000010001
11110116111111911101020010001
11000000110101011100000010001
10000000008000301100000010001
1000000000k000001101010010001
11000001110101011111011110N0111
11110111 1110101 101111010001
11111111 1111111 111111111111
